1111111111111
1C010000C0001
1000011111001
1P0011E00C001
110000C111111
1000C000C0001
1111111111111
